// Stages
var stage1 = "
  |---------------------------------------------------------------|
  |:                                                              |
  |----   ----    -----   --                                      |
  |*************************|\    ---    ---                      |
  |--------------------------------           --------------------|
  |                                         /|********************|
  |                                        / |********************|
  |        -----------------------------------********************|
  |    ---                                                        |
  |                                           ---       ---     --|
  |---    -----------   -----   -- -  --   -|***********|         |
  |                                         |-----------|   ---   |
  |                                                               |
  |                                                     |---|    ;|
  |*****************************************************|---------|";
